Lim,
0,650,2260,0,
0,650,2260,650,
0,470,
FLim,
Enemies,
scorpio,4,
400,85,62,35,0,580,85,85,
1660,85,62,35,1540,2140,85,85,
1780,85,62,35,1540,2140,85,85,
1900,85,62,35,1540,2140,85,85,
topo,2,
1120,92,86,42,1060,1360,92,92,
1240,92,86,42,1060,1360,92,92,
FEnemies,
desbloquea,
Level1.1,
2260,650,50,650,
Fdesbloquea,
powers,
default,
Fpowers,