Lim,
0,650,1860,-910,
0,650,1860,1560,
0,200,
FLim,
Enemies,
light,3,
390,71,41,71,390,390,0,1560,
390,1560,41,71,390,390,0,1560,
390,780,41,71,390,390,0,1560,
bird,5,
1020,300,108,75,900,1080,300,300,
1260,420,108,75,1140,1360,360,480,
1020,660,108,75,900,1140,660,660,
120,840,108,75,120,240,780,900,
750,1200,108,75,750,750,1140,1260,
FEnemies,
desbloquea,
Level1.0,
1860,1560,50,1560,
Fdesbloquea,
powers,
default,terra,aero,
Fpowers,
